OOOOXXXXXXXXXXXXOOOO
OOOOOOOOOOOOOOOOOOOO
OOOOOOOOOOOOOOOOOOOO
OOOOOOOOOOOOOOOOOOOO
XOOOOOOOOOOOOOOOOOOX
XOOOOOOOOOOOOOOOOOOX
XOOOOOOOOOOOOOOOOOOX
XOOOOOOOOOOOOOOOOOOX
XOOOOOOOOOOOOOOOOOOX
XOOOOOOOOOOOOOOOOOOX
OOOOOOOOOOOOOOOOOOOO
OOOOOOOOOOOOOOOOOOOO
OOOOOOOOOOOOOOOOOOOO
OOOOXXXXXXXXXXXXOOOO
300